2200000000022
2000000000002
0000000000000
0000000000000
0000000000000
2000000000002
2200000000022