aa000000000aa
aa000000000aa
0000000000000
0000009000000
0000000000000
aa000000000aa
aa000000000aa