8000000000008
0000000000000
0000000000000
0000009000000
0000000000000
0000000000000
8000000000008