o00010001000o
3333300033333
0000000000000
0000000000000
0000000000000
3333300033333
o00010001000o