0000000000000
0000000000000
0000033300000
000003u300000
0000033300000
0000000000000
0000000000000