0303000000000
0303000000000
0303000003030
0303000003030
0303000003030
0000000003030
0000000003030