e00000000000e
0000000000000
0000000000000
000000i000000
0000000000000
0000000000000
e00000000000e