0000100010000
3333300033333
0000000000000
0000000000000
0000000000000
3333300033333
0000100010000