0000000000000
0000000000000
003000p000300
0030008000300
003000p000300
0000000000000
0000000000000