2222200022222
2222200022222
00000o0o00000
0000000000000
00000o0o00000
2222200022222
2222200022222