2200000000022
2y000000000y2
3330000000333
0000008000000
3330000000333
2y000000000y2
2200000000022