0000000000000
0000000000000
000000o000000
00000oqo00000
000000o000000
0000000000000
0000000000000