8000000000008
0000000000000
0003000003000
000000d00000
0003000003000
0000000000000
8000000000008