2222200022222
0000000000000
0000000000000
000000o000000
0000000000000
0000000000000
2222200022222