2222200022222
2222200022222
0000000000000
000000r000000
0000000000000
2222200022222
2222200022222