0000000000000
0000333330000
0000300030000
0000300030000
0000300030000
0000333330000
0000000000000