u00000000000u
0000000000000
0000000000000
000000i000000
0000000000000
0000000000000
u00000000000u