0000000000000
00u0000000u00
0000000000000
000000p000000
0000000000000
00u0000000u00
0000000000000