8000000000008
0000000000000
00030w1w03000
0000012100000
00030w1w03000
0000000000000
8000000000008