0000000000000
0000003000000
000300p003000
0003008003000
000300p003000
0000003000000
0000000000000