0000000000000
0000000000000
00000www00000
0000w0i0w0000
00000www00000
0000000000000
0000000000000