0000000000000
0000000000000
0000a000a0000
0000009000000
0000a000a0000
0000000000000
0000000000000