8000000000008
0000000000000
0003001003000
0000012100000
0003001003000
0000000000000
8000000000008