0000000000000
0000000000000
00t0000000t00
000000e000000
00t0000000t00
0000000000000
0000000000000