d00000000000d
0000000000000
00000sss00000
00000sss00000
00000sss00000
0000000000000
d00000000000d