8888300038888
3333300033333
0000000000000
000000y000000
0000000000000
3333300033333
8888300038888