8000000000008
0100000000010
00030w0w03000
0000000000000
00030w0w03000
0100000000010
8000000000008