0000000000000
0000000000000
0000002000000
0020i000i0200
0000000000000
0000002000000
0000000000000