d00000000000d
0000000000000
000008i800000
00000i9i00000
000008i800000
0000000000000
d00000000000d