2200000000022
2000000000002
0000088800000
0000088800000
0000088800000
2000000000002
2200000000022